31 28
L C C C C C C M L C C C C C C C C M O L C C C C C C C M
B Q P P P P P R B P P P P P P P P R O B P P P P P P Q R
B P L S S M P R B P L M P P P P P R O B P P P P L M P R
B P R L C N P R B P R E S S S G P R O B P P P P R B P R
B P R B P P P R B P R F C C G B P R O B P F S S N B P R
B P R I S M P R B P R B P P R B P R O B P R L S M B P R
B P R L C N P E H P R B P P R B P E C H P R I C N B P R
B P R B P P P P P P R B P P R B P P P P P E C C M B P R
B P R I S M P P P P R B P P R B P P P P P P P P I N P I
N P I C C N P F G P I N P P I N P P P F G P P P P P P P
P P P P P P P R B P P P P P P P P P P R B P P P P P P L
M P P P P P P R B P P P P P P P P P P R B P P P P P P R
B P F S S S S N B P T K Y 0 0 W K U P R I S S S S G P R
B P E C C C C M B P J 0 0 0 0 0 0 J P R L C C C C H P R
B P P P P P P R B P J 0 0 0 0 0 0 J P R B P P P P P P R
B P F S S G P R B P J 0 0 0 0 0 0 J P R B P F S S G P R
B P R O O B P R B P Z K K K K K K V P R B P R O O B P R
B P R O O B P R B P P P P P P P P P P R B P R O O B P R
B P E C C H P E H P F S S S S S S G P E H P E C C H P R
B P P P P P P P P P E C C M L C C H P P P P P P P P P R
E S S S S G P F G P P P P R B P P P P F G P F S S S S H
C C C C C H P R I S S G P R B P F S S N B P E C C C C C
P P P P P P P R L C C H P E H P E C C M B P P P P P P P
S S S S S G P R B P P P P P P P P P P R B P F S S S S S
F C C C C H P R B P F S S S S S S G P R B P E C C C C G
B P P P P P P E H P E C C M L C C H P E H P P P P P P R
B P P P F G P P P P P P P R B P P P P P P P F G P P P R
B P F S N I S S G P F G P R B P F G P F S S N I C G P R
B P E C C C C C H P R B P E H P R B P E C C C C C H P R
B Q P P P P P P P P R B P P P P R B P P P P P P P P Q R
I S S S S S S S S S N I S S S S N I S S S S S S S S S N
