31 28
L C C C C C C C C C C C C C C C C C C C C C C C C C C M
B Q P P P P P P P P P P P P P P P P P P P P P P P P Q R
B P F G P F S S G P F S S S S S S G P F S S G P F G P R
B P R B P E C M B P E C C M L C C H P R L C H P R B P R
B P R B P P P R B P P P P R B P P P P R B P P P R B P R
B P R I S G P R B P F G P R B P F G P R B P F S N B P R
H P E C C H P E H P R B P R B P R B P E H P E C C H P E
P P P P P P P P P P R B P E H P R B P P P P P P P P P P
S S S G P F S S G P R B P P P P R B P F S S G P F S S S
L C C H P E C M B P R I S S S S N B P R L C H P E C C M
B P P P P P P R B P E C C C C C C H P R B P P P P P P R
B P F S S G P R B P P P P P P P P P P R B P F S S G P R
B P E C M B P R B P T K Y 1 1 W K U P R B P R L C H P R
B P P P R B P E H P J 0 0 0 0 0 0 J P E H P R B P P P R
I S G P R B P P P P J 0 0 0 0 0 0 J P P P P R B P F S N
0 0 B P R B P F G P J 0 0 0 0 0 0 J P F G P R B P R 0 0
0 0 B P E H P R B P Z K K K K K K V P R B P E H P R 0 0
0 0 B P P P P R B P P P P P P P P P P R B P P P P R 0 0
0 0 B P F S S N B P F G P F G P F G P R I S S G P R 0 0
C C H P E C C C H P R B P R B P R B P E C C C H P E C C
P P P P P P P P P P R B P R B P R B P P P P P P P P P P
S S G P F S S S S S N B P R B P R I S S S S S G P F S S
L C H P E C C C C C C H P E H P E C C C C C C H P E C M
B P P P P P P P P P P P P P P P P P P P P P P P P P P R
B P F S S G P F G P F S S S S S S G P F G P F S S G P R
B P R L C H P R B P E C C M L C C H P R B P E C M B P R
B P R B P P P R B P P P P R B P P P P R B P P P R B P R
B P R B P F S N I S S G P R B P F S S N I S G P R B P R
B P E H P E C C C C C H P R B P E C C C C C H P E H P R
B P P P P P P P P P P P P R B P P P P P P P P P P P P R
I S S S S S S S S S S S S N I S S S S S S S S S S S S N
