31 28
L C C C C C C M L C C C C C C C C C C M L C C C C C C M
B Q P P P P P R B P P P P P P P P P P R B P P P P P Q R
B P F S S G P R B P F S S S S S S G P R B P F S S G P R
B P R O O B P R B P E C C M L C C H P R B P R O O B P R
B P E C C H P R B P P P P R B P P P P R B P E C C H P R
B P P P P P P R B P F G P R B P F G P R B P P P P P P R
B P F G P F S N B P R B P R B P R B P R I S G P F G P R
B P R B P E C C H P R B P E H P R B P E C C H P R B P R
B P R B P P P P P P R B P P P P R B P P P P P P R B P R
B P R I S G P F G P R I S S S S N B P F G P F S N B P R
H P E C C H P R B P E C C C C C C H P R B P E C C H P E
P P P P P P P R B P P P P P P P P P P R B P P P P P P P
G P F G P F S N B P T K Y 0 0 W K U P R I S G P F G P F 
B P R B P E C M B P J 0 0 0 0 0 0 J P R L C H P R B P R
B P R B P P P R B P J 0 0 0 0 0 0 J P R B P P P R B P R
B P R I S G P R B P J 0 0 0 0 0 0 J P R B P F S N B P R
B P R L C H P E H P Z K K K K K K V P E H P E C M B P R
B P R B P P P P P P P P P P P P P P P P P P P P R B P R
B P R B P F S S S S S G P F G P F S S S S S G P R B P R
B P E H P E C C C C M B P R B P R L C C C C H P E H P R
B P P P P P P P P P R B P R B P R B P P P P P P P P P R
B P F S S S S S G P R B P R B P R B P F S S S S S G P R
B P E C C M L C H P E H P E H P E H P E C M L C C H P R
B P P P P R B P P P P P P P P P P P P P P R B P P P P R
B P F G P R B P F S S G P F G P F S S G P R B P F G P R
B P R B P E H P R L C H P R B P E C M B P E H P R B P R
B P R B P P P P R B P P P R B P P P R B P P P P R B P R
B P R I S S G P R B P F S N I S G P R B P F S S N B P R
B P E C C C H P E H P E C C C C H P E H P E C C C H P R
B Q P P P P P P P P P P P P P P P P P P P P P P P P Q R
I S S S S S S S S S S S S S S S S S S S S S S S S S S N
