31 28
L C C C C C C C C C C C C C C C C C C C C C C C C C C M
B Q P P P P P P P P P P P P P P P P P P P P P P P P Q R
B P F S S S S S G P F S S S S S S G P F S S S S S G P R
B P E C M L C C H P E C C C C C C H P E C C M L C H P R
B P P P R B P P P P P P P P P P P P P P P P R B P P P R
I S M P R B P F S S S G P F G P F S S S G P R B P L S N
O O B P R B P R O O O B P R B P R O O O B P R B P R O O
C C N P E H P E C C C H P R B P E C C C H P E H P I C C
P P P P P P P P P P P P P R B P P P P P P P P P P P P P
G P F S S G P F G P F S S N I S S G P F G P F S S G P F
B P E C M B P R B P E C C C C C C H P R B P R L C H P R
B P P P R B P R B P P P P P P P P P P R B P R B P P P R
I S M P R B P R B P T K Y 0 0 W K U P R B P R B P L S N
O O B P E H P R B P J 0 0 0 0 0 0 J P R B P E H P R O O
O O B P P P P R B P J 0 0 0 0 0 0 J P R B P P P P R O O
O O B P F S S N B P J 0 0 0 0 0 0 J P R I S S G P R O O
L C N P E C C C H P Z K K K K K K V P E C C C H P I C M
B P P P P P P P P P P P P P P P P P P P P P P P P P P R
B P F S S G P F G P F S S S S S S G P F G P F S S G P R
B P E C M B P R B P E C C M L C C H P R B P R L C H P R
B P P P R B P R B P P P P R B P P P P R B P R B P P P R
I S G P R B P R I S S G P R B P F S S N B P R B P F S N
C C H P E H P R L C C H P E H P E C C M B P E H P E C C
P P P P P P P R B P P P P P P P P P P R B P P P P P P P
S S G P F G P R B P F S S S S S S G P R B P F G P F S S
L C H P R B P E H P E C C M L C C H P E H P R B P E C M
B P P P R B P P P P P P P R B P P P P P P P R B P P P R
B P F S N I S S G P F G P R B P F G P F S S N I C G P R
B P E C C C C C H P R B P E H P R B P E C C C C C H P R
B Q P P P P P P P P R B P P P P R B P P P P P P P P Q R
I S S S S S S S S S N I S S S S N I S S S S S S S S S N
